    NO   				./Textures/path_to_the_north_texture    
WE 		./Textures/path_to_the_west_texture
		SO 			./Textures/path_to_the_south_texture
EA 	./Textures/path_to_the_east_texture 

F    220,269,10
C 225,30,10


        1111111111111111111111111
        100000000011000000000000111111111111111
        1011000001110000000000001      100001
        1001000000000000000000001      111111    
111111111011000001110000000000001
10000000001100000111011111111111
11110111111111011100000010001
11110111111111011101010010001
11000000110101011100000010001
1000000000000001100000010001
10000000000000001101010010001
1100001110101011111011110N0111
11110111 1110101 101111010001
11111111 1111111 111111111111

11111
11111
11111
