NO textures/north.xpm
SO textures/south.xpm
WE textures/west.xpm
EA textures/east.xpm

F 255,208,75
C 225,30,0

        111111111111111111111111
        1000000000110000000000001
        1011000001110000010010001
        100100000000000000E00001
111111111011000001110000000000001
100000000011000001110111111111111
11110111111111011100000010001
11110111011111011101010010001  111
11000000110101011 100000010001  10111
10000000000000001100000010001  111
10000000000000001101010010001
1100000111010101111101111010111
11110111 1110101 11111010001
11111111 1111111 111 11111111
